0 0 0 0 0 4 4 4 4 4 0 0 0 0 0 0 0 0 4 4 4 4 4 0
0 0 0 0 0 0 0 0 0 0 0 0 0 0 0 0 0 0 0 3 3 3 7 0
0 0 0 0 0 0 0 0 0 0 0 0 0 3 3 3 0 0 0 1 1 1 1 0
0 1 1 0 0 0 6 6 0 0 0 0 0 1 1 1 0 0 0 4 4 4 4 0
0 4 4 0 0 0 1 1 1 0 0 0 0 0 0 0 0 0 0 0 0 0 0 5
0 0 0 0 0 0 0 0 0 0 0 0 0 0 0 0 0 0 0 0 0 2 2 5
0 0 0 0 1 1 0 0 0 0 6 0 0 0 0 0 0 0 0 0 0 0 0 5
0 0 0 0 0 0 0 0 0 1 1 1 0 0 0 0 0 1 1 1 0 0 0 5
0 0 0 0 0 0 0 0 0 4 4 4 0 0 0 0 0 0 0 0 0 0 0 5
0 0 0 0 6 0 0 0 0 0 0 0 0 0 0 0 0 0 0 1 1 1 0 0
1 1 0 0 1 1 0 0 1 1 1 0 0 0 1 1 0 0 0 4 4 4 0 0
1 1 0 0 0 0 0 0 1 1 1 0 0 0 1 1 0 0 0 0 0 0 0 0
